SELECT 
	MATCH_ID, MATCH_DATETIME, LEAGUE, HOME_TEAM, AWAY_TEAM, HOME_FT_GOAL, AWAY_FT_GOAL, 
--    STR_HDA_O_MACAU_H, STR_HDA_O_MACAU_D, STR_HDA_O_MACAU_A, 
--    END_HDA_O_MACAU_H, END_HDA_O_MACAU_D, END_HDA_O_MACAU_A, 
--    ROUND((END_HDA_O_MACAU_H-STR_HDA_HOME_MEAN)/STR_HDA_O_MACAU_H,2),
--    ROUND((END_HDA_O_MACAU_D-STR_HDA_DRAW_MEAN)/STR_HDA_O_MACAU_D,2),
--    ROUND((END_HDA_O_MACAU_A-STR_HDA_AWAY_MEAN)/STR_HDA_O_MACAU_A,2),
	STR_HDA_O_HKJC_H, STR_HDA_O_HKJC_D, STR_HDA_O_HKJC_A, 
	END_HDA_O_HKJC_H, END_HDA_O_HKJC_D, END_HDA_O_HKJC_A,
	ROUND((END_HDA_O_HKJC_H-STR_HDA_HOME_MEAN)/STR_HDA_O_HKJC_H,2) as HKJC_H_DIFF,
	ROUND((END_HDA_O_HKJC_D-STR_HDA_DRAW_MEAN)/STR_HDA_O_HKJC_D,2) as HKJC_D_DIFF,
	ROUND((END_HDA_O_HKJC_A-STR_HDA_AWAY_MEAN)/STR_HDA_O_HKJC_A,2) as HKJC_A_DIFF
FROM FULL_VIEW
WHERE

	ROUND((END_HDA_O_HKJC_A-STR_HDA_AWAY_MEAN)/STR_HDA_O_HKJC_A,2)<-0.04 AND ROUND((END_HDA_O_HKJC_D-STR_HDA_DRAW_MEAN)/STR_HDA_O_HKJC_D,2)<-0.04
--MATCH_ID=1753228
ORDER BY MATCH_DATETIME DESC;


MatchID	MATCH_ID
日期	MATCH_DATETIME
聯賽	LEAGUE
主隊	HOME_TEAM
客隊	AWAY_TEAM
完主入球	HOME_FT_GOAL
完客入球	AWAY_FT_GOAL
半主入球	HOME_HT_GOAL
半客入球	AWAY_HT_GOAL
賽果	HDA_RESULT
大細澳彩	HILO_MACAU_RESULT
大細馬會	HILO_HKJC_RESULT
初盤	STR_HDA_MATCH_HANDICAP
初主平均	STR_HDA_HOME_MEAN
初主中位	STR_HDA_HOME_MEDIAN
初和平均	STR_HDA_DRAW_MEAN
初和中位	STR_HDA_DRAW_MEDIAN
初客平均	STR_HDA_AWAY_MEAN
初客中位	STR_HDA_AWAY_MEDIAN
初主澳彩	STR_HDA_O_MACAU_H
初和澳彩	STR_HDA_O_MACAU_D
初客澳彩	STR_HDA_O_MACAU_A
初主馬會	STR_HDA_O_HKJC_H
初和馬會	STR_HDA_O_HKJC_D
初客馬會	STR_HDA_O_HKJC_A
終盤	END_HDA_MATCH_HANDICAP
終主平均	END_HDA_HOME_MEAN
終主中位	END_HDA_HOME_MEDIAN
終和平均	END_HDA_DRAW_MEAN
終和中位	END_HDA_DRAW_MEDIAN
終客平均	END_HDA_AWAY_MEAN
終客中位	END_HDA_AWAY_MEDIAN
終主澳彩	END_HDA_O_MACAU_H
終和澳彩	END_HDA_O_MACAU_D
終客澳彩	END_HDA_O_MACAU_A
終主馬會	END_HDA_O_HKJC_H
終和馬會	END_HDA_O_HKJC_D
終客馬會	END_HDA_O_HKJC_A
初大細澳彩盤	STR_MACAU_HILO_HANDICAP
初大澳彩	STR_MACAU_HILO_HI
初細澳彩	STR_MACAU_HILO_LO
初大細馬會盤	STR_HKJC_HILO_HANDICAP
初大馬會	STR_HKJC_HILO_HI
初細馬會	STR_HKJC_HILO_LO
終大細澳彩盤	END_MACAU_HILO_HANDICAP
終大澳彩	END_MACAU_HILO_HI
終細澳彩	END_MACAU_HILO_LO
終大細馬會盤	END_HKJC_HILO_HANDICAP
終大馬會	END_HKJC_HILO_HI
終細馬會	END_HKJC_HILO_LO
初讓盤數	STR_ASIAN_MODE_CNT
初讓普遍盤	STR_ASIAN_MODE_HDC
初讓平均	STR_ASIAN_O_AVG
初讓中位	STR_ASIAN_O_MEDIAN
初讓澳彩盤	STR_ASIAN_MACAU_HDC
初讓主澳彩	STR_ASIAN_O_MACAU_H
初讓客澳彩	STR_ASIAN_O_MACAU_A
初讓馬會盤	STR_ASIAN_HKJC_HDC
初讓主馬會	STR_ASIAN_O_HKJC_H
初讓客馬會	STR_ASIAN_O_HKJC_A
終讓盤數	END_ASIAN_MODE_CNT
終讓普遍盤	END_ASIAN_MODE_HDC
終讓平均	END_ASIAN_O_AVG
終讓中位	END_ASIAN_O_MEDIAN
終讓澳彩盤	END_ASIAN_MACAU_HDC
終讓主澳彩	END_ASIAN_O_MACAU_H
終讓客澳彩	END_ASIAN_O_MACAU_A
終讓馬會盤	END_ASIAN_HKJC_HDC
終讓主馬會	END_ASIAN_O_HKJC_H
終讓客馬會	END_ASIAN_O_HKJC_A
冷熱主	BETFA_HOME_HC_IDX
冷熱和	BETFA_DRAW_HC_IDX
冷熱客	BETFA_AWAY_HC_IDX
飛數主	TOTAL_HOME_TIX
飛數和	TOTAL_DRAW_TIX
飛數客	TOTAL_AWAY_TIX


終讓馬會盤	終讓主馬會	終讓客馬會	終讓澳彩盤	終讓主澳彩	終讓客澳彩	終大細馬會盤	終大馬會	終細馬會	終大細澳彩盤	終大澳彩	終細澳彩	澳彩提示